string	string	string
字段	中文	英文
Key	CN	EN
		
//公共相关		
Common_System	系统	System
Common_SystemNotice	系统公告	System notice
Common_Sure	确定	Sure
Common_Cancel	取消	Cancel
Common_Any_Close	点击任意空白区域关闭	
Common_Title	提示	
Common_Login	登录	
		
		
test	需求解锁-%s	
test2	电影院	
Function_Build_Hotlepreserve_01	修复大厅	
Function_Build_Hotlepreserve_02	建造小费罐	
Function_Build_Hotlepreserve_03	解锁餐厅	
Function_Build_Hotlepreserve_04	修复楼梯	
Function_Build_Hotlepreserve_05	修复二楼地板	
Function_Build_Hotlepreserve_06	建造房间201	
Function_Build_Hotlepreserve_07	建造告示栏	
Function_Build_Hotlepreserve_08	建造房间202	
Function_Build_Hotlepreserve_09	建造二楼功能房	
Function_Build_Hotlepreserve_10	修复楼顶	
Function_Build_tip_name	小费上限	
Function_Build_tip_desc	你可以获得一个更大更大的小费罐，但是愿意给多少可得完全看客人们的心情了。	
Function_Build_afktime_name	离线收益	
Function_Build_afktime_desc	你已经是一个成熟的旅店了，需要学会自己赚钱了。	
Function_Build_autoserve_name	旅店宣传	
Function_Build_autoserve_desc	我们的客人总是慕名而来。	
Furniture_Lounge_initial_bed_name	廉价小床	
Furniture_Lounge_initial_bed_desc	廉价的普通小床，除了一分钱一分货这个质朴的优点以外。没有其他值得称道的地方。	
Furniture_Lounge_field_01_name	一号床铺	
Furniture_Lounge_field_02_name	门厅	
Furniture_Lounge_field_03_name	二号床铺	
Furniture_Lounge_field_04_name	前门柜	
Furniture_Lounge_field_05_name	思考区	
Furniture_Lounge_field_06_name	特产展示	
Furniture_Lounge_field_07_name	三号床铺	
Furniture_Lounge_field_08_name	沙发	
Furniture_Lounge_field_09_name	展示柜	
Furniture_Lounge_field_10_name	四号床铺	
Furniture_Lounge_field_11_name	娱乐区	
Furniture_Lounge_field_12_name	休息区	
Furniture_Lounge_field_13_name	墙	
Furniture_Lounge_field_14_name	卧室地板	
Furniture_Lounge_field_15_name	卧室地板	
Furniture_Lounge_field_16_name	大厅地板	
Function_house_name_01	休息室	
Function_house_name_02	单人间201	
Function_house_name_03	餐厅	
Function_house_name_04	单人间202	
Function_house_name_05	温泉	
Function_house_desc_01	休闲，品茗，棋牌	
Function_house_desc_02	尊贵的单人专属房间	
Function_house_desc_03	提供来自魔界的真正黑暗料理	
Function_house_desc_04	尊贵的单人专属房间	
Function_house_desc_05	请自行调节水温	
Furniture_Lounge_initial_frontdesk_name	简易柜子	
Furniture_Lounge_initial_frontdesk_desc	这是一个可以打开并且可以在方面放置物品的本分柜子。	
Furniture_Lounge_initial_dooradorn_name	朴素门饰	
Furniture_Lounge_initial_dooradorn_desc	通过在门口摆放装饰可以让环境显得不那么寒酸，但如果拿寒酸的东西摆放在门口就另说了。	
Furniture_Lounge_initial_paying02_name	自助占卜	
Furniture_Lounge_initial_paying02_desc	*“心诚则灵，本设备不含魔法“*	
Furniture_Lounge_initial_paying01_name	魔能饮料	
Furniture_Lounge_initial_paying01_desc	那么代价是什么呢？	
Furniture_Lounge_initial_sofa_name	古董沙发	
Furniture_Lounge_initial_sofa_desc	古董不一定值钱，但是一定很旧。	
Furniture_Lounge_initial_selling_name	传统坩埚	
Furniture_Lounge_initial_selling_desc	来自家乡的传统口味，干净又卫生。	
Furniture_Lounge_initial_gamearea_name	儿童玩具	
Furniture_Lounge_initial_gamearea_desc	对于小孩子可能太幼稚了，但是对于小怪物刚刚好。	
Furniture_Lounge_initial_restarea_name	和睦座椅	
Furniture_Lounge_initial_restarea_desc	在进行干瞪眼游戏时，先生气的人就算输了。	
Furniture_Lounge_initial_wall_name	战损墙面	
Furniture_Lounge_initial_wall_desc	充满了历史的底蕴。	
Furniture_Lounge_initial_groundroom1_name	厚德地板	
Furniture_Lounge_initial_groundroom1_desc	基于人体工程力学在使用过程中覆盖了厚厚的缓冲层。	
Furniture_Lounge_initial_groundhouse_name	载物地板	
Furniture_Lounge_initial_groundhouse_desc	有点塌陷不过问题不大。	
Common_furnitureparam_xxs	休息室收入+%s	
Common_furnitureparam_idle	每分钟收入+%s	
Common_furnitureparam_used	使用后收入+%s	
Common_furnitureparam_exter	30秒额外收入+%s	
Common_furnitureparam_DuraMax	库存数量+%s	
Common_furnitureparam_grade	人气值+%s	
Common_furnitureparam_term	需要人气达到	
Common_furnitureparam_Ltime	在休息室中睡觉时间减少%s	
Common_button_use	使用	
Common_button_useing	使用中	
Common_button_buy	购 买	
Common_button_buyfast	立刻购买	
Common_button_speedup	加速	
Common_button_gainspeed	获取加速	
Common_field_unlock	需要解锁	
Common_hint_usejewel	是否花费	
Common_hint_speedup	你所拥有的加速不足以完成本次购买，是否去获取更多的加速时间。	
Common_button_speed_Sure	前往获取	
Common_button_speed_cancel	任性使用	
Commom_renqidemand	旅店人气	
Commom_transittime	需要运输	
Common_getcoin	获取金币	
Common_getjewel	获取钻石	
Common_getrenqi	获取人气	
Common_coin	金币	
Common_jewel	钻石	
Common_renqi	人气	
Common_coin_desc	在小怪物中极度普及的黄金色货币。	
Common_jewel_desc	”啊！我的宝贝！“	
Common_renqi_desc	基于1787魔性《人权法案》为基准，此处可以使用”人气“一词。	
Furniture_Lounge_pinks_bed_name	粉色小床	
Furniture_Lounge_pinks_bed_desc	静卧与柔软与甜蜜之上。	
Furniture_Lounge_pinks_frontdesk_name	落日记事台	
Furniture_Lounge_pinks_frontdesk_desc	进门之前随便写点什么吧。	
Furniture_Lounge_pinks_dooradorn_name	伞架入户柜	
Furniture_Lounge_pinks_dooradorn_desc	总会有人需要在雨天出行。	
Furniture_Lounge_pinks_paying02_name	塔罗占卜台	
Furniture_Lounge_pinks_paying02_desc	关于你最近的厄运这只羊应该没办法提供有建设性的意见。	
Furniture_Lounge_pinks_paying01_name	传统咖啡壶	
Furniture_Lounge_pinks_paying01_desc	并没有咖啡师，你可以尝试完全按照自己想象中的样子做咖啡。	
Furniture_Lounge_pinks_sofa_name	小憩沙发	
Furniture_Lounge_pinks_sofa_desc	安心休息，当沙漏流光时，猫咪雕像便会活过来将你叫醒。	
Furniture_Lounge_pinks_selling_name	炼金制药柜	
Furniture_Lounge_pinks_selling_desc	骷髅兄弟：能帮忙搭把手吗？	
Furniture_Lounge_pinks_gamearea_name	象棋地垫	
Furniture_Lounge_pinks_gamearea_desc	优雅，实在太优雅了。	
Furniture_Lounge_pinks_restarea_name	粉色小方桌	
Furniture_Lounge_pinks_restarea_desc	夏天夏天悄悄过去留下小秘密。	
Furniture_Lounge_pinks_wall_name	草莓奶油墙	
Furniture_Lounge_pinks_wall_desc	就像是草莓口味的牛奶方砖。	
Furniture_Lounge_pinks_groundroom1_name	马赛克糖纸地板	
Furniture_Lounge_pinks_groundroom1_desc	门口拆开了一块！	
Furniture_Lounge_pinks_groundhouse_name	草莓巧克力砖	
Furniture_Lounge_pinks_groundhouse_desc	让我看看是谁偷偷掰走了。	
Common_UItips_furniture	设 施	
Common_UItips_Details	详 情	
Common_UItips_bulid	旅 店	
Common_hotle_block1	旅店属性	
Common_hotle_block2	旅店维护	
Commom_ontransi	运输中	
Commom_timeremaining	剩余运输时间	
Common_transportend	已完成	
client_name_01	小恶魔	
client_desc_01	恶魔之子，以成为最火热的靓仔为目标，不可一世的精神小伙。	
Common_Title_transport	当前栏位尚有其他家具正在运输中。	
Common_Title_nospeedup	加速时间不足。	
Common_unlock	解锁	
Function_Build_afktime_param	离线收益上限	
Function_Build_autoserve_param	自动招揽间隔	
Common_level_max	MAX	
Common_afktime_param	离线时间	
Common_afktime_limit	上限	
Common_button_get	获取	
Common_button_getmore	获取更多	
Common_Energy_Recover_01	提供赞助，立即为扭蛋机补货！	
Common_Energy_Recover_02	%s后将自动恢复%s个扭蛋	
Common_Energy_Recover_button_01	赞助	
Common_Energy_Recover_button_02	联系赞助商	
Common_Energy_Recover_tips	扭蛋机补货	
Common_Energy_Recover_03	扭蛋机已塞满，请先抽取一些扭蛋再来。	
Common_Energy_Recover_04	是否花费钻石为扭蛋机补货。	
Common_Energy_Recover_05	免费次数刷新：	
Furniture_Lounge_shining_bed_name	复古木床	
Furniture_Lounge_shining_bed_desc	本旅店并不建议在遇到不明情况时躲在床底下。	
Furniture_Lounge_shining_frontdesk_name	典雅前台	
Furniture_Lounge_shining_frontdesk_desc	抱歉特价房只能在线上预订。	
Furniture_Lounge_shining_dooradorn_name	道具组合	
Furniture_Lounge_shining_dooradorn_desc	东西先放这，当问题出现我再告诉大家。	
Furniture_Lounge_shining_paying02_name	居家工作台	
Furniture_Lounge_shining_paying02_desc	只工作不玩耍，聪明杰克也犯傻	
Furniture_Lounge_shining_paying01_name	蓝色小洋装	
Furniture_Lounge_shining_paying01_desc	从某些方面来说穿上这个裙子并不会让人显得可爱。	
Furniture_Lounge_shining_sofa_name	宴会余温	
Furniture_Lounge_shining_sofa_desc	宴会刚刚结束，而你大可不必为了未能加入而遗憾。	
Furniture_Lounge_shining_selling_name	侍酒吧台	
Furniture_Lounge_shining_selling_desc	暂停营业	
Furniture_Lounge_shining_gamearea_name	植物迷宫	
Furniture_Lounge_shining_gamearea_desc	记住了就请去亲自试试吧。	
Furniture_Lounge_shining_restarea_name	茶饮茶桌	
Furniture_Lounge_shining_restarea_desc	一切都准备好勒请就坐。	
Furniture_Lounge_shining_wall_name	雪中小屋	
Furniture_Lounge_shining_wall_desc	来都来了就多呆一阵吧。	
Furniture_Lounge_shining_groundroom1_name	方格地板	
Furniture_Lounge_shining_groundroom1_desc	装饰了经典花纹的精美地点。	
Furniture_Lounge_shining_groundhouse_name	光洁木地板	
Furniture_Lounge_shining_groundhouse_desc	前厅的打扫可是重中之重。	
Hotlebuild_tips	请先	
Common_jiasu	运输加速	
Common_jiasu_desc	地狱特快准时达。	
Furniture_Lounge_Egypt_bed_name	远古兽足床	
Furniture_Lounge_Egypt_bed_desc	古埃及人通常在你称为「床头」的方位放脚。	
Furniture_Lounge_Egypt_frontdesk_name	来生映像	
Furniture_Lounge_Egypt_frontdesk_desc	能映射出来生的景象，大可不必为此影响今天的心情。	
Furniture_Lounge_Egypt_dooradorn_name	巴斯苔特坐像	
Furniture_Lounge_Egypt_dooradorn_desc	甜美的猫猫同时也是荒野的战神。	
Furniture_Lounge_Egypt_paying02_name	悬浮金字塔	
Furniture_Lounge_Egypt_paying02_desc	「看！飞碟！」	
Furniture_Lounge_Egypt_paying01_name	灵魂天平	
Furniture_Lounge_Egypt_paying01_desc	人固有一死，魂重于泰山，或轻于鸿毛。	
Furniture_Lounge_Egypt_sofa_name	尼罗河映像	
Furniture_Lounge_Egypt_sofa_desc	从时光的流沙中把过往的点滴打捞起来。	
Furniture_Lounge_Egypt_selling_name	斯芬克斯之谜	
Furniture_Lounge_Egypt_selling_desc	程咬金但文化人。	
Furniture_Lounge_Egypt_gamearea_name	死亡之书	
Furniture_Lounge_Egypt_gamearea_desc	「毁灭吧！赶紧的！」- 梅杰德	
Furniture_Lounge_Egypt_restarea_name	杜阿穆特夫罐	
Furniture_Lounge_Egypt_restarea_desc	不要大吃大喝了，这一顿好好养胃吧。	
Furniture_Lounge_Egypt_wall_name	墓室砖墙	
Furniture_Lounge_Egypt_wall_desc	原汁原味。	
Furniture_Lounge_Egypt_groundroom1_name	墓室方砖地板	
Furniture_Lounge_Egypt_groundroom1_desc	精美还原地道的地道风格。	
Furniture_Lounge_Egypt_groundhouse_name	埃及方砖地板	
Furniture_Lounge_Egypt_groundhouse_desc	埃及方砖拥有岁月都难以打磨掉的艳丽颜色。	
Customer_Angry_Tips_1	希望下次来你能准备好我想要的！	
Customer_Angry_Tips_2	看来我要考虑下次是否会再来了！	
Customer_Angry_Tips_3	你让我等待太久了！	
Customer_Angry_Tips_4	希望你们明白，提供完整的服务是对客人的尊重！	
Customer_Angry_Tips_5	这简直是最糟糕的一次住店体验！	
Customer_Wait_tips_1	希望不会等太久~	
Customer_Wait_tips_2	充满了期待	
Customer_Wait_tips_3	有时候等待也是一种乐趣	
Customer_Wait_tips_4	排队是人气的体现~	
Customer_EM_Use_tips_1	这里看起来不错~	
Customer_EM_Use_tips_2	这里正和我意~	
Customer_EM_Use_tips_3	算点什么好呢	
Customer_EM_Use_tips_4	我好像看到了我自己的牌	
Customer_EM_Use_tips_5	我讨厌工作！	
Customer_EM_Use_tips_6	我想我的朋友会喜欢这个	
Customer_EM_Use_tips_7	精力充沛~	
Customer_EM_Use_tips_8	魔力~魔力~	
Customer_EM_Use_tips_9	人类饮料？也不错~	
Customer_EM_Use_tips_10	你可别想我穿这个！	
Customer_EM_Use_tips_11	没人可以审判我	
Customer_EM_Use_tips_12	唔~真舒服~	
Customer_EM_Use_tips_13	是我喜欢的味道	
Customer_EM_Use_tips_14	休息一下	
Customer_EM_Use_tips_15	下午茶，或许值得一试	
Customer_EM_name	小恶魔	
Customer_EM_desc	个头小小的他很喜欢恶作剧，接待他的时候你可要小心了	
Furniture_Lounge_vampire_bed_name	法兰绒饰床	
Furniture_Lounge_vampire_bed_desc	无尽长夜中未必尽是美梦。	
Furniture_Lounge_vampire_frontdesk_name	无言的门童	
Furniture_Lounge_vampire_frontdesk_desc	来访者请自行写下名字，这里同样很欢迎新朋友。	
Furniture_Lounge_vampire_dooradorn_name	玫瑰剑格	
Furniture_Lounge_vampire_dooradorn_desc	「爱与死的轮舞」	
Furniture_Lounge_vampire_paying02_name	时光遗珠	
Furniture_Lounge_vampire_paying02_desc	当这些小玩意从床底、沙发缝里被掏出来的时候，并没意识到会被评价为「有品位」。	
Furniture_Lounge_vampire_paying01_name	无声的钢琴	
Furniture_Lounge_vampire_paying01_desc	这架随时以使用状态展示的钢琴，琴键却被锁死了。	
Furniture_Lounge_vampire_sofa_name	法兰绒沙发	
Furniture_Lounge_vampire_sofa_desc	「对于时钟的滴答声不再敏感，说明你已经是个成熟得吸血鬼了。」
Furniture_Lounge_vampire_selling_name	神秘学工作台
Furniture_Lounge_vampire_selling_desc	「我知道这不科学。但是你为什么要跟一个吸血鬼谈科学呢。」
Furniture_Lounge_vampire_gamearea_name	陈旧的书信
Furniture_Lounge_vampire_gamearea_desc	再也没人陪你玩「当年」的老梗了。
Furniture_Lounge_vampire_restarea_name	玫瑰私语
Furniture_Lounge_vampire_restarea_desc	当同时纯在两个一模一样的复刻场景，就显得没那么浪漫了。
Furniture_Lounge_vampire_wall_name	深邃迷墙
Furniture_Lounge_vampire_wall_desc	与之相比窗外的黑夜都成了闪烁的点缀。
Furniture_Lounge_vampire_groundroom1_name	忐忑重叠地砖
Furniture_Lounge_vampire_groundroom1_desc	除了好厉害的名字之外没什么特别的。
Furniture_Lounge_vampire_groundhouse_name	混沌棋盘地砖
Furniture_Lounge_vampire_groundhouse_desc	黑与白亦可以交织融合。